00000033000000330000000000
00000033000000330000000000
22110033000000110011001100
22110033000000110011001100
22110022222200110011331100
22110022222211110011331100
22000011000011110033000033
22000011000011110033000033
22000011001133000011221133
22000011001133000011221133
22220011111100003311220000
22220011111100003311220000
11111111112222331111221100
11111111112222331111221100
00000033221100110011001100
00000033221100110011001100
33114433001100110044441144
33114433001100110044441144
44110011001111110011331144
44110011001111110011331144
44110011001111110000000044
44110011001111110000000044
44110000000000000011001144
44110000000111100011001144
44110011000100100011111100
44110011000100100011111100
