00000033000100100000000000
00000033000100100000000000
22110033000111110011001100
22110033000000110011001100
22110022002200110011331100
22110022002211110011331100
22000011000011110033000033
22000011000011110033000033
22000011001133000011221133
22000011001133000011221133
22220011001100003311220000
22220011001100003311220000
11111111002222331111221100
11111111002222331111221100
00000033001100110011001100
00000033001100110011001100
33114433001100110044441144
33114433001100110044441144
44110011001111110011331144
44110011001111110011331144
44110011001111110000000044
44110011000000000000000000
00000000000000000000000000
00000000000111100011001144
44110011000100100011111100
44110011000100100011111100
